1111111111111111111111111111111111
1E0000000000000C00000C000000000001
10100101001000001O100100O000010101
10100100101010100010010000O0010101
1P0000000C00C0000000000000000000C1
1111111111111111111111111111111111