11111111111111111111111111111111111111111111111111111111111111111111111111111111111111111111111111111111111111111111111111111111111111111111111111111111111
100000000000000C00000C00000000000100000000000000C00000CO0000000000100000000000000CO0000C000000000001100000000000000C00000C0000000000011100000000000000C0001
11111000000000O0000C00000C00000000000110000000O000000CO0000C000000000001111100000000000000C00000C00000000000O0000000000000C00000C000000000001100000000000E1
100000000000000CO0000C00000000000E111100000000000000CO0000C0000000000010000000000O000C00000C0000000000011110O000000000000C00000C000000000001110000000000001
10000000000000OC00000C00000000000100000O00000000C0000OC00000000000100000000000000C0000OC000000000001100000000000O00C00000C0000000000011100000000000000C0001
1111100000000000000C00000C000000000001100000O00000000C00000C0000000000011111000000000O0000C00000C0000000000000000O00000000C00000C000000000001100000000000E1
1000P0000000000C00000C00000000000E111100000000000000C00000C0000000000010000000000000OC00000C00000000000111100000000000000C00000C000000000001110000000000001
11111111111111111111111111111111111111111111111111111111111111111111111111111111111111111111111111111111111111111111111111111111111111111111111111111111111