1111111111111
1C01000E000C1
100C01111101
1P0011E000001
1101111111111