1111111111111
1111000EC0001
1000Z11111001
1P0011EC00001
1111111111111