1111111111111
1C01000E000C1
100C011111001
100011E000001
1111111111111