1111111111111
1C010000000C1
100C011111001
1P00110000001
1111111111111